initialize_shell_variables--./variables.c	FAULTY_F_KP_8
do_redirection_internal--./execute_cmd.c	FAULTY_F_KP_9
brace_gobbler--./braces.c	FAULTY_F_SK_1
make_command_string_internal--./print_cmd.c	FAULTY_F_SK_2
attempt_shell_completion--./bashline.c	FAULTY_F_SK_4
execute_command_internal--./execute_cmd.c	FAULTY_F_SK_5
change_signal--./trap.c	FAULTY_F_SK_7
_rl_get_screen_size--./lib/readline/terminal.c	FAULTY_F_SPK_1
insert_match--./lib/readline/complete.c	FAULTY_F_SPK_10
tilde_expand--./lib/readline/tilde.c	FAULTY_F_SPK_7
parse_shell_options--./shell.c	FAULTY_F_KP_1
_rl_update_final--./lib/readline/display.c	FAULTY_F_KP_10
_run_trap_internal--./trap.c	FAULTY_F_KP_2
move_to_high_fd--./general.c	FAULTY_F_KP_3
array_expand_index--./subst.c	FAULTY_F_KP_4
expland--./expr.c	FAULTY_F_KP_5
unwind_frame_discard_internal--./unwind_prot.c	FAULTY_F_KP_6
rl_clear_screen--./lib/readline/readline.c	FAULTY_F_KP_7
assign_array_from_string--./variables.c	FAULTY_F_SK_3
expcond--./expr.c	FAULTY_F_SK_6
_visible_names--./variables.c	FAULTY_F_SK_8
canonicalize_pathname--./general.c	FAULTY_F_SPK_2
command_substitute--./subst.c	FAULTY_F_SPK_3
execute_builtin--./execute_cmd.c	FAULTY_F_SPK_4
execute_disk_command--./execute_cmd.c	FAULTY_F_SPK_5
the_printed_command_resize--./print_cmd.c	FAULTY_F_SPK_8
rl_redisplay--./lib/readline/display.c	FAULTY_F_SPK_9
